555555555
533353335
525252525
525252525
515151515
515111515
555555515